Mattias	Alm
Andreas	Andersson
Amanda	Andersson
John	Aronsson
Percy	Bolmer
Carl Erik	Bong Nilsson
Jonas	Claesson
Robin	Egbo
Emilio	Essen
Tobias	Frick
Jan	Frick
Elena	Genova
Gustav	Hellqvist
Love	Hjorth
Andre	Jansson
Timmie	Jensen
Christopher	Johansson
Marcus	Johansson
Daniel	Karlsson
Jolina	Kollander Noresson
Sabo	Krcic
Bata	Malesev
Elias	Nilsson Sjöström
Rasmus	Norgren
Philip	Pålsson
Robin	Rosengren
Jem	Salltun
Christofer	Schoerner
Martin	Sjölin
Andreas	Sjöström
Rikard	Svensson
Matilda	Svensson
Simone	Svensson
Filip	Thomasson
Julia	Tranberg
Michael	Wendt
Elric	Zand